7 7
WWWWWWW
W  WE W
WW WW W
W     W
W W WWW
W W  SW
WWWWWWW
