7 13
WWWWWWWWWWWWW
W     S     W
W WWWWWWWWW W
W     W     W
WWWWW W WWWWW
W     W    EW
WWWWWWWWWWWWW
