5 5
WWWWW
W   W
W S W
W  EW
WWWWW
