5 5
WWWWW
WS  W
W   W
W  EW
WWWWW
