7 7
WWWWWWW
WS    W
W W W W
W     W
W W W W
W    EW
WWWWWWW
