11 7
WWWWWWW
WS    W
WWWWW W
W     W
W WWWWW
W     W
WWWWW W
W     W
W WWWWW
W    EW
WWWWWWW
