7 7
WWWWWWW
WS W  W
WW WW W
W     W
WWW WWW
W    EW
WWWWWWW
