7 7
WWWWWWW
WW   WW
W W W W
W  S  W
W W W W
WW  EWW
WWWWWWW
