8 7
WWWWWWW
W  WEWW
WW W  W
W   W W
W W   W
W W WWW
W W  SW
WWWWWWW
