6 6
WWWWWW
WS   W
W    W
W    W
W   EW
WWWWWW
