7 7
WWWWWWW
WS W  W
WW WW W
W     W
W W WWW
W W  EW
WWWWWWW
