7 7
WWWWWWW
W  WE W
WW WW W
W     W
WWW WWW
WS    W
WWWWWWW
