7 7
WWWWWWW
W     W
W     W
W  S  W
W     W
W    EW
WWWWWWW
