7 13
WWWWWWWWWWWWW
W   W    W  W
W W W WW WW W
WWW   SW    W
W   WWWWW WWW
W W   W    EW
WWWWWWWWWWWWW
