7 6
WWWWWW
WS W W
WW W W
W    W
W W WW
WW  EW
WWWWWW
